R 600 600
NO ./texture/wall_illusion1/0.png
SO ./texture/wall_illusion2/0.png
WE ./texture/wall_illusion3/0.png
EA ./texture/wall_illusion4/0.png
S ./texture/sprite1/0.png
F 211,134,156
C 156,178,111


111111111111111111111111111111111111111111111111111111111111111111111111111111111111111111111111111111111111 
102020202020202020202020202020110221102020202020202020202020202020202020202020202020202020202020202020202021
102020202020202020200202022011020200211020202020202020202020202020202020202020202020202020202020202020202021
102020202020202020202020202102020202022102020202020202020202020202020202020202020202020202020202020202020201
102020202010202020202020201020202020220210202020202020202020202020202020202020202020202020202020202020202021
102020202010202020202020210202020202022021020202020202020202020202020202020202020202020202020202020202020201
102020202010202020202020102020202020202202102020202020202020202020202020202020202020202020202020202020202021
102020202020202020202020102022020200202202102020202020202020202020202020202020202020202020202020202020202021
102020202020202020202021020220020220020220210202020202020202020202020202020202020202020202020202020202020201
102020202020202020202021020202020202020220210202020202020202020202020202020202020202020202020202020202020201
102011102020202020022010202020202020202020221020202020202020202020202020202020202020202020202020202020202021
10202020202020202020202020202020202020202022102020202020202020202020202020202020202020202020202020202020202111
10202020202020202020201020202020202002020202102020202020202020202020202020202020202020202020202020202020202021
10202020202020202020202102020202020020202021020202020202020202020202020202020202020202020202020202020202020111
102020202020202020202021020202020202020220210202020202020202020202020202020202020202020202020202020202020201
102020202020202020202020102020202020202202102020202020202020202020202020202020202020202020202020202020202021
102020202020202020202020102020202020202202102020202020202020202020202020202020202020202020202020202020202021
102020202020202020202020210202020202022021020202020202020202020202020202020202020202020202020202020202020201
102020202020202020202020201020202020220210202020202020202020202020202020202020202020202020202020202020202021
102020202020202020202020202102020202002102020202020202020202020202020202020202020202020202020202020202020201
102020202020202020202020202011020200211020202020202020202020202020202020202020202020202020202020202020202021
102020202020202020202020202020110221102020202020202020202020202020202020202020202020202020202020202020202021
102020202020202020202020202020201110202020202020202020202020202020202020202020202020202020202020202020202021
102020202020202020202020202020202020202020202020202020202020202020202020202020202020202020202020202020202021
102020202020202020202020202020202020202020202020202020202020202020202020202020202020202020202020202020202021
102020202020202020202020202020202020202020202020202020202020202020202020202020202020202020202020202020202021
102020202020202020202020202020202020202020202020202020202020202020202020202020202020202020202020202020202021
102020202020202020202020202020202020202020202020202020202020202020202020202020202020202020202020202020202021
102020202020202020202020202020202020202020202020202020202020202020202020202020202020202020202020202020202021
102020202020202020202020202020202020202020202020202020202020202020202020202020202020202020202020202020202021
102020202020202020202020202020202020202020202020202020202020202020202020202020202020202020202020202020202021
102020202020202020202020202020202020202020202020202020202020202020202020202020202020202020202020202020202021
102020202020202020202020202020202020202020202020202020202020202020202020202020202020202020202020202020202021
102020202020202020202020202020202020202020202020202020202020202020202020202020202020202020202020202020202021
102020202020202020202020202020202020202020202020202020202020202020202020202020202020202020202020202020202021
102020202020202020202020202020202020202020202020202020202020202020202020202020202020202020202020202020202021
102020202020202020202020202020202020202020202020202020202020202020202020202020202020202020202020202020202021
102020202020202020202020202020202020202020202020202020202020202020202020202020202020202020202020202020202021
102020202020202020202020202020202020202020202020202020202020202020202020202020202020202020202020202020202021
102020202020202020202020202020202020202020202020202020202020202020202020202020202020202020202020202020202021
102020202020202020202020202020202020202020202020202020202020202020202020202020202020202020202020202020202021
102020202020202020202020202020202020202020202020202020202020202020202020202020202020202020202020202020202021
102020202020202020202020202020202020202020202002020202020202020202020202020202020202020202020202020202020221
102020202020202020202020202020202211111111111111111111111110202020202020202020202020202020202020202020202021
102020202020202020202020202020202020202020202020202020202002020202020202020202020202020202020202020202020221
102020202020202020202020202020202020202020202020202020202020202020202020202020202020202020202020202020202021
102020202020202020202020202020202020202020202002020202020202020202020202020202020202020202020202020202020221
102020202020202020202020202020202020202020202020202020202020202020202020202020202020202020202020202020202021
1020202020202020202020202020202020202020202020N0202020202020202020202020202020202020202020202020202020202021
102020202020202020202020202020202020202020202020202020202020202020202020202020202020202020202020202020202021
102020202020202020202020202020202020202020202020202020202020202020202020202020202020202020202020202020202021
102020202020202020202020202020202020202020202020202020202020202020202020202020202020202020202020202020202021
102020202020202020202020202020202020202020202020202020202020202020202020202020202020202020202020202020202021
102020202020202020202020202020202020202020202020202020202020202020202020202020202020202020202020202020202021
102020202020202020202020202020202020202020202020202020202020202020202020202020202020202020202020202020202021
102020202020202020202020202020202020202020202020202020202020202020202020202020202020202020202020202020202021
111111111111111111111111111111111111111111111111111111111111111111111111111111111111111111111111111111111111
