R 1200 1200
NO ./texture/other/purplestone.png
SO ./texture/wall_illusion2/0.png
WE ./texture/wall_illusion3/0.png
EA ./texture/wall_illusion4/0.png
S ./texture/sprite1/0.png
F 211,134,156
C 156,178,111


111111111111111111111111111111111111111111111111111111111111111111111111111111111111111111111111111111111111 
122222222222222222222222222220112221122222222222222222222222222222222222222222222222222222222222222222222221
122222222222222222202222222011222202211222222222222222222222222222222222222222222222222222222222222222222221
122222222222222222222222222122222222222122222222222222222222222222222222222222222222222222222222222222222201
122222222012222222222222201222222222220212222222222222222222222222222222222222222222222222222222222222222221
122222222012222222222222212222222222222021222222222222222222222222222222222222222222222222222222222222222201
122222222012222222222220122222222222222202122222222222222222222222222222222222222222222222222222222222222221
122222222222222222222220122222020202222202122222222222222222222222222222222222222222222222222222222222222221
122222222222222222222221222220222220222220212222222222222222222222222222222222222222222222222222222222222201
122222222222222222222221222222222222222220212222222222222222222222222222222222222222222222222222222222222201
122011122222222220222012222222222222222222221222222222222222222222222222222222222222222222222222222222222221
12222222222222222222222222222222222222222222122222222222222222222222222222222222222222222222222222222222222111
12222222222222222222201222222222222022222222122222222222222222222222222222222222222222222222222222222222222221
12222222222222222222222122222222020222222221222222222222222222222222222222222222222222222222222222222222220111
122222222222222222222221222222222222222220212222222222222222222222222222222222222222222222222222222222222201
122222222222222222222220122222222222222202122222222222222222222222222222222222222222222222222222222222222221
122222222222222222222220122222222222222202122222222222222222222222222222222222222222222222222222222222222221
122222222222222222222222212222222222222021222222222222222222222222222222222222222222222222222222222222222201
122222222222222222222222201222222222220212222222222222222222222222222222222222222222222222222222222222222221
122222222222222222222222222122222222022122222222222222222222222222222222222222222222222222222222222222222201
122222222222222222222222222011222202211222222222222222222222222222222222222222222222222222222222222222222221
122222222222222222222222222220112221122222222222222222222222222222222222222222222222222222222222222222222221
122222222222222222222222222222201112222222222222222222222222222222222222222222222222222222222222222222222221
122222222222222222222222222222222222222222222222222222222222222222222222222222222222222222222222222222222221
122222222222222222222222222222222222222222222222222222222222222222222222222222222222222222222222222222222221
122222222222222222222222222222222222222222222222222222222222222222222222222222222222222222222222222222222221
122222222222222222222222222222222222222222222222222222222222222222222222222222222222222222222222222222222221
122222222222222222222222222222222222222222222222222222222222222222222222222222222222222222222222222222222221
122222222222222222222222222222222222222222222222222222222222222222222222222222222222222222222222222222222221
122222222222222222222222222222222222222222222222222222222222222222222222222222222222222222222222222222222221
122222222222222222222222222222222222222222222222222222222222222222222222222222222222222222222222222222222221
122222222222222222222222222222222222222222222222222222222222222222222222222222222222222222222222222222222221
122222222222222222222222222222222222222222222222222222222222222222222222222222222222222222222222222222222221
122222222222222222222222222222222222222222222222222222222222222222222222222222222222222222222222222222222221
122222222222222222222222222222222222222222222222222222222222222222222222222222222222222222222222222222222221
122222222222222222222222222222222222222222222222222222222222222222222222222222222222222222222222222222222221
122222222222222222222222222222222222222222222222222222222222222222222222222222222222222222222222222222222221
122222222222222222222222222222222222222222222222222222222222222222222222222222222222222222222222222222222221
122222222222222222222222222222222222222222222222222222222222222222222222222222222222222222222222222222222221
122222222222222222222222222222222222222222222222222222222222222222222222222222222222222222222222222222222221
122222222222222222222222222222222222222222222222222222222222222222222222222222222222222222222222222222222221
122222222222222222222222222222222222222222222222222222222222222222222222222222222222222222222222222222222221
122222222222222222222222222222222222222222222022222222222222222222222222222222222222222222222222222222222221
122222222222222222222222222222222211111111111111111111111112222222222222222222222222222222222222222222222221
122222222222222222222222222222222020202020202020202020202022222222222222222222222222222222222222222222222221
122222222222222222222222222222222222222222222222222222222222222222222222222222222222222222222222222222222221
122222222222222222222222222222222222222222222022222222222222222222222222222222222222222222222222222222222221
122222222222222222222222222222222222222222222222222222222222222222222222222222222222222222222222222222222221
1222222222222222222222222222222222222222222220N2222222222222222222222222222222222222222222222222222222222221
122222222222222222222222222222222222222222222222222222222222222222222222222222222222222222222222222222222221
122222222222222222222222222222222222222222222222222222222222222222222222222222222222222222222222222222222221
122222222222222222222222222222222222222222222222222222222222222222222222222222222222222222222222222222222221
122222222222222222222222222222222222222222222222222222222222222222222222222222222222222222222222222222222221
122222222222222222222222222222222222222222222222222222222222222222222222222222222222222222222222222222222221
122222222222222222222222222222222222222222222222222222222222222222222222222222222222222222222222222222222221
122222222222222222222222222222222222222222222222222222222222222222222222222222222222222222222222222222222221
111111111111111111111111111111111111111111111111111111111111111111111111111111111111111111111111111111111111
