R 2000 1000
NO ./texture/wall_illusion1/0.png
SO ./texture/wall_illusion2/0.png
WE ./texture/wall_illusion3/0.png
EA ./texture/wall_illusion4/0.png
S ./texture/sprite1/0.png
F 255,100,0
C 225,30,0

     1111111111111111111111111     1111
     1000000000110000000000001     1001
     1011000001110000002000001     1111
111111000000000000000000000001111
111111011011000001110000000001111
100000000011000001110111111111111
11110111111111011100000010001
11110111111111011101010010001
11000000110101011100000010001
10002000000000001100000010001
10000000000000001101010010001
11000001110101011111011110N0111
11110111 1110101 101111010001
11111111 1111111 111111111111