R 1200 1200
NO ./texture/wall_illusion1/0.png
S ./texture/wall_illusion2/0.png
WE ./texture/wall_illusion3/0.png
EA ./texture/wall_illusion4/0.png
SO ./texture/sprite1/0.png
F 211,134,156
C 156,178,111

11111111111111111
10100100120100001
10000000120000001
10000000120000001
10000000200000001
10000000000000001
10000000N00000001
10000000000000001
10000000000000001
10000000000000001
11111111111111111